WWWWWW
W000WW
WX0X0W
W0000W
W0000W
WWWWWW
1,1
2,2
2,3

(0,1)