WWWWWWW
W0000WW
W00000W
0WWX0XW
W00000W
WWWWWWW
1,1
2,2
2,3

